MapNumber,15
MapTip,1,1,1,1,1,1,1,1,1,1,1,1,1,1,1,1,1,1
MapTip,1,0,0,0,0,0,0,0,0,0,0,0,0,0,0,0,0,1
MapTip,1,0,0,0,0,0,0,0,0,0,0,0,0,0,0,0,0,1
MapTip,1,0,0,0,0,0,0,0,0,0,0,0,0,0,0,0,0,1
MapTip,1,0,0,0,0,0,0,0,0,0,0,0,1,1,1,1,11,1
MapTip,1,0,0,0,0,0,0,0,0,0,0,0,0,0,0,0,0,1
MapTip,1,0,0,0,0,0,0,0,0,0,0,0,0,0,0,0,0,1
MapTip,1,1,0,0,0,0,0,0,0,0,0,0,0,0,0,0,0,1
MapTip,1,1,0,0,1,1,1,1,1,1,1,1,1,1,1,1,1,1
MapTip,1,1,0,0,0,0,0,0,1,1,1,1,1,1,1,1,1,1
MapTip,1,1,0,0,0,0,0,0,1,1,1,1,1,1,1,1,1,1
MapTip,1,1,0,0,0,0,0,0,1,1,1,1,1,1,1,1,1,1
MapTip,1,1,10,12,1,1,12,0,1,1,1,1,1,1,1,1,1,1
MapTip,1,1,1,1,1,1,1,1,1,1,1,1,1,1,1,1,1,1