MapNumber,14
MapTip,1,1,1,1,1,1,1,1,1,1,1,1,1,1,1,1,1,1
MapTip,1,0,0,0,0,0,0,0,0,0,0,0,0,0,0,0,0,1
MapTip,1,0,0,0,0,0,0,0,0,0,0,0,0,0,0,0,0,1
MapTip,1,0,0,0,0,0,0,0,0,0,0,0,0,0,0,0,0,1
MapTip,1,11,1,1,1,1,1,1,1,0,0,0,0,0,0,0,0,1
MapTip,1,0,0,0,0,0,0,0,0,0,0,0,0,0,0,0,3,1
MapTip,1,0,0,0,0,0,0,0,0,0,0,0,0,1,1,1,1,1
MapTip,1,0,0,0,0,0,0,0,0,1,1,1,1,1,1,1,1,1
MapTip,1,0,0,0,0,0,0,0,0,1,1,1,1,1,1,1,1,1
MapTip,1,0,0,0,0,0,0,0,0,1,1,1,1,1,1,1,1,1
MapTip,1,10,1,12,0,1,1,0,0,1,1,1,1,1,1,1,1,1
MapTip,1,1,1,1,0,0,0,3,0,1,1,1,1,1,1,1,1,1
MapTip,1,1,1,1,1,1,1,1,1,1,1,1,1,1,1,1,1,1
MapTip,1,1,1,1,1,1,1,1,1,1,1,1,1,1,1,1,1,1